,Predictable end sentence,Unpredictable end sentence,Taget word,pred_num_letters,pred_end_n_LPC,pred_num_words,unpred_num_letters,unpred_end_n_LPC,unpred_num_words,delta_tletters,delta_words,phon_pred,phon_unpred
0,Les deux étudiants se sont rencontrés et sont rapidement tombés amoureux.,Les deux voisins se sont croisés et ont compris qu'ils étaient amoureux.,amoureux,62,"19, except ['rapidement'], check the cv for: {'les': 1, 'étudiants': 4, 'sont': 1, 'rencontrés': 4, 'tombés': 2, 'amoureux': 3}",11,60,"21, except [""qu'ils""], check the cv for: {'les': 1, 'voisins': 3, 'sont': 1, 'croisés': 4, 'ont': 1, 'compris': 3, 'étaient': 2, 'amoureux': 3}",12,2,-1,"le   d2   e-ty-d-j@   s2   s§   R@-k§-t-Re   e   s§   t§-be   a-mu-R2   ,except ['rapidement'], check the phon for: {'les': 'le', 'étudiants': 'etydj@', 'sont': 's§', 'rencontrés': 'R@k§tRe', 'tombés': 't§be', 'amoureux': 'amuR2'}","le   d2   v-wa-z5   s2   s§   k-R-wa-ze   e   §   k§-p-Ri   e-tE   a-mu-R2   ,except [""qu'ils""], check the phon for: {'les': 'le', 'voisins': 'vwaz5', 'sont': 's§', 'croisés': 'kRwaze', 'ont': '§', 'compris': 'k§pRi', 'étaient': 'etE', 'amoureux': 'amuR2'}"
1,"Les jours ensoleillés, Jacques se rend au parc pour promener son chien.","Le lundi matin, Léa croise toujours cette femme et son chien.",chien,58,"24, check the cv for: {'les': 1, 'ensoleillés': 4, 'pour': 2, 'son': 1}",12,49,"20, except ['léa'], check the cv for: {'le': 1, 'son': 1}",11,9,1,"le   Zu-R   @-so-lE-je   Za-k   s2   R@   o   pa-R-k   pu-R   p-RO-m-ne   s§   S-j5   ,check the cv for: {'les': 'le', 'ensoleillés': '@solEje', 'pour': 'puR', 'son': 's§'}","l2   l1-di   ma-t5   k-R-wa-z   tu-Zu-R   sE-t   fa-m   e   s§   S-j5   ,except ['léa'], check the phon for: {'le': 'l2', 'son': 's§'}"
2,Faites attention à ne pas toucher la poêle quand elle est chaude.,Attendons-nous à ce que l'assiette soit plus chaude.,chaude,53,"21, check the cv for: {'faites': 2, 'attention': 4, 'pas': 1, 'toucher': 2, 'la': 1, 'poêle': 3, 'quand': 1, 'est': 1, 'chaude': 2}",12,44,"13, except [""l'assiette""], check the cv for: {'ce': 1, 'que': 1, 'soit': 2, 'plus': 2, 'chaude': 2}",9,9,3,"fE-t   a-t@-s-j§   a   n2   pa   tu-Se   la   p-wa-l   k@   E-l   e   So-d   ,check the cv for: {'faites': 'fEt', 'attention': 'at@sj§', 'pas': 'pa', 'toucher': 'tuSe', 'la': 'la', 'poêle': 'pwal', 'quand': 'k@', 'est': 'e', 'chaude': 'Sod'}","a-t@-d§   nu   a   s2   k2   s-wa   p-ly   So-d   ,except [""l'assiette""], check the phon for: {'ce': 's2', 'que': 'k2', 'soit': 'swa', 'plus': 'ply', 'chaude': 'Sod'}"
3,Briser un miroir vous causera des années de malheur.,Écouter Ines vous donnera l'habitude du malheur.,malheur,43,"16, except ['causera'], check the cv for: {'un': 1, 'de': 1}",9,41,"8, except ['ines', 'donnera', ""l'habitude""], check the cv for: {}",7,2,2,"b-Ri-ze   1   mi-R-wa-R   vu   de   a-ne   d2   ma-l9-R   ,except ['causera'], check the phon for: {'un': '1', 'de': 'd2'}","e-ku-te   vu   dy   ma-l9-R   ,except ['ines', 'donnera', ""l'habitude""], check the phon for: {}"
4,Émilie l’avait détesté dès le moment où ils s'étaient rencontrés.,Les collègues ne s'attendent pas à revenir là où ils se sont rencontrés.,rencontrés,55,"15, except ['émilie', 'l’avait', ""s'étaient""], check the cv for: {'détesté': 4, 'le': 1, 'où': 1, 'rencontrés': 4}",10,59,"17, except [""s'attendent"", 'revenir'], check the cv for: {'les': 1, 'pas': 1, 'là': 1, 'où': 1, 'sont': 1, 'rencontrés': 4}",13,-4,-3,"de-tE-s-te   dE   l2   mo-m@   u   i-l   R@-k§-t-Re   ,except ['émilie', 'l’avait', ""s'étaient""], check the phon for: {'détesté': 'detEste', 'le': 'l2', 'où': 'u', 'rencontrés': 'R@k§tRe'}","le   ko-lE-g   n2   pa   a   la   u   i-l   s2   s§   R@-k§-t-Re   ,except [""s'attendent"", 'revenir'], check the phon for: {'les': 'le', 'pas': 'pa', 'là': 'la', 'où': 'u', 'sont': 's§', 'rencontrés': 'R@k§tRe'}"
5,Les faux jumeaux étaient aussi différents que le jour et la nuit.,Les jeunes femmes avaient toujours aimé se balader pendant la nuit.,nuit,53,"19, check the cv for: {'les': 1, 'faux': 1, 'étaient': 2, 'différents': 3, 'que': 1, 'le': 1, 'la': 1, 'nuit': 2}",12,56,"21, check the cv for: {'les': 1, 'jeunes': 2, 'avaient': 2, 'aimé': 2, 'pendant': 2, 'la': 1, 'nuit': 2}",11,-3,1,"le   fo   Zy-mo   e-tE   o-si   di-fe-R@   k2   l2   Zu-R   e   la   n-8i   ,check the cv for: {'les': 'le', 'faux': 'fo', 'étaient': 'etE', 'différents': 'difeR@', 'que': 'k2', 'le': 'l2', 'la': 'la', 'nuit': 'n8i'}","le   Z9-n   fa-m   a-vE   tu-Zu-R   e-me   s2   ba-la-de   p@-d@   la   n-8i   ,check the cv for: {'les': 'le', 'jeunes': 'Z9n', 'avaient': 'avE', 'aimé': 'eme', 'pendant': 'p@d@', 'la': 'la', 'nuit': 'n8i'}"
6,La petite fille était excitée de perdre sa première dent.,Le vieil homme s'inquiétait de perdre une nouvelle dent.,dent,47,"21, except ['petite'], check the cv for: {'la': 1, 'était': 2, 'excitée': 4, 'de': 1, 'sa': 1, 'première': 5}",10,47,"17, except [""s'inquiétait""], check the cv for: {'le': 1, 'de': 1, 'une': 2, 'nouvelle': 3}",9,0,1,"la   fi-j   e-tE   E-k-si-te   d2   pE-R-d-R   sa   p-R2-m-jE-R   d@   ,except ['petite'], check the phon for: {'la': 'la', 'était': 'etE', 'excitée': 'Eksite', 'de': 'd2', 'sa': 'sa', 'première': 'pR2mjER'}","l2   v-jE-j   O-m   d2   pE-R-d-R   y-n   nu-vE-l   d@   ,except [""s'inquiétait""], check the phon for: {'le': 'l2', 'de': 'd2', 'une': 'yn', 'nouvelle': 'nuvEl'}"
7,"Si certains couteaux étaient tranchants, d'autres étaient très émoussés.","Si cette montagne restait très visitée, ses rochers étaient très émoussés.",émoussés,62,"21, check the cv for: {'si': 1, 'certains': 3, 'étaient': 2, 'tranchants': 3, ""d'autres"": 3, 'émoussés': 3}",9,62,"24, check the cv for: {'si': 1, 'ses': 1, 'étaient': 2, 'émoussés': 3}",11,0,-2,"si   sE-R-t5   ku-to   e-tE   t-R@-S@   do-t-R   e-tE   t-RE   e-mu-se   ,check the cv for: {'si': 'si', 'certains': 'sERt5', 'étaient': 'etE', 'tranchants': 'tR@S@', ""d'autres"": 'dotR', 'émoussés': 'emuse'}","si   sE-t   m§-ta-N   RE-s-tE   t-RE   vi-zi-te   se   Ro-Se   e-tE   t-RE   e-mu-se   ,check the cv for: {'si': 'si', 'ses': 'se', 'étaient': 'etE', 'émoussés': 'emuse'}"
8,"Au concert de rock, la musique était extrêmement forte.","Dans le vieux port, la brise était encore plus forte.",forte,45,"16, except ['extrêmement'], check the cv for: {'de': 1, 'rock': 2, 'la': 1, 'musique': 3, 'était': 2, 'forte': 3}",9,42,"20, check the cv for: {'le': 1, 'vieux': 2, 'la': 1, 'brise': 3, 'était': 2, 'plus': 2, 'forte': 3}",10,3,-1,"o   k§-sE-R   d2   RO-k   la   my-zi-k   e-tE   fO-R-t   ,except ['extrêmement'], check the phon for: {'de': 'd2', 'rock': 'ROk', 'la': 'la', 'musique': 'myzik', 'était': 'etE', 'forte': 'fORt'}","d@   l2   v-j2   pO-R   la   b-Ri-z   e-tE   @-kO-R   p-ly   fO-R-t   ,check the cv for: {'le': 'l2', 'vieux': 'vj2', 'la': 'la', 'brise': 'bRiz', 'était': 'etE', 'plus': 'ply', 'forte': 'fORt'}"
9,"Pour fêter sa promotion, les amis de Maya lui ont organisé une fête.","Depuis la rue, les enfants pouvaient entendre le bruit de la fête.",fête,54,"28, check the cv for: {'pour': 2, 'sa': 1, 'les': 1, 'amis': 2, 'de': 1, 'maya': 2, 'lui': 2, 'ont': 1, 'organisé': 5, 'une': 2, 'fête': 2}",13,53,"19, except ['depuis'], check the cv for: {'la': 1, 'rue': 1, 'les': 1, 'le': 1, 'bruit': 3, 'de': 1, 'fête': 2}",12,1,1,"pu-R   fe-te   sa   p-Ro-mo-s-j§   le   a-mi   d2   ma-ja   l-8i   §   O-R-ga-ni-ze   y-n   fE-t   ,check the cv for: {'pour': 'puR', 'sa': 'sa', 'les': 'le', 'amis': 'ami', 'de': 'd2', 'maya': 'maja', 'lui': 'l8i', 'ont': '§', 'organisé': 'ORganize', 'une': 'yn', 'fête': 'fEt'}","la   Ry   le   @-f@   pu-vE   @-t@-d-R   l2   b-R-8i   d2   la   fE-t   ,except ['depuis'], check the phon for: {'la': 'la', 'rue': 'Ry', 'les': 'le', 'le': 'l2', 'bruit': 'bR8i', 'de': 'd2', 'fête': 'fEt'}"
10,"Pendant la randonnée, les pieds de Lila lui faisaient plus mal à chaque pas.","Pendant la réunion, les enfants ont décidé de faire un pas.",pas,61,"20, except ['lila', 'faisaient'], check the cv for: {'pendant': 2, 'la': 1, 'randonnée': 3, 'les': 1, 'de': 1, 'lui': 2, 'plus': 2, 'mal': 2, 'pas': 1}",14,47,"19, check the cv for: {'pendant': 2, 'la': 1, 'les': 1, 'ont': 1, 'décidé': 3, 'de': 1, 'un': 1, 'pas': 1}",11,14,3,"p@-d@   la   R@-do-ne   le   p-je   d2   l-8i   p-ly   ma-l   a   Sa-k   pa   ,except ['lila', 'faisaient'], check the phon for: {'pendant': 'p@d@', 'la': 'la', 'randonnée': 'R@done', 'les': 'le', 'de': 'd2', 'lui': 'l8i', 'plus': 'ply', 'mal': 'mal', 'pas': 'pa'}","p@-d@   la   Re-y-n-j§   le   @-f@   §   de-si-de   d2   fE-R   1   pa   ,check the cv for: {'pendant': 'p@d@', 'la': 'la', 'les': 'le', 'ont': '§', 'décidé': 'deside', 'de': 'd2', 'un': '1', 'pas': 'pa'}"
11,"Thaïs étant en retard, elle n'arrêtait pas de regarder sa montre.","Elsa quittant l'entreprise, elle s'était vu offert une montre.",montre,53,"13, except ['retard', ""n'arrêtait"", 'regarder'], check the cv for: {'étant': 2, 'en': 1, 'pas': 1, 'de': 1, 'sa': 1, 'montre': 3}",11,52,"13, except ['elsa', ""l'entreprise"", ""s'était""], check the cv for: {'vu': 1, 'une': 2, 'montre': 3}",9,1,2,"ta-j   e-t@   @   E-l   pa   d2   sa   m§-t-R   ,except ['retard', ""n'arrêtait"", 'regarder'], check the phon for: {'étant': 'et@', 'en': '@', 'pas': 'pa', 'de': 'd2', 'sa': 'sa', 'montre': 'm§tR'}","ki-t@   E-l   vy   o-fE-R   y-n   m§-t-R   ,except ['elsa', ""l'entreprise"", ""s'était""], check the phon for: {'vu': 'vy', 'une': 'yn', 'montre': 'm§tR'}"
12,"Après sa blessure, le petit oiseau ne pouvait plus voler.","Pendant la nuit, le papillon avait recommencé à voler.",voler,46,"18, except ['petit'], check the cv for: {'après': 3, 'sa': 1, 'le': 1, 'plus': 2}",10,44,"14, except ['recommencé'], check the cv for: {'pendant': 2, 'la': 1, 'nuit': 2, 'le': 1, 'avait': 2}",9,2,1,"a-p-RE   sa   b-le-sy-R   l2   wa-zo   n2   pu-vE   p-ly   vo-le   ,except ['petit'], check the phon for: {'après': 'apRE', 'sa': 'sa', 'le': 'l2', 'plus': 'ply'}","p@-d@   la   n-8i   l2   pa-pi-j§   a-vE   a   vo-le   ,except ['recommencé'], check the phon for: {'pendant': 'p@d@', 'la': 'la', 'nuit': 'n8i', 'le': 'l2', 'avait': 'avE'}"
13,La couleur la plus associée à la colère est le rouge.,Le vieux voilier possède une grande voile rouge.,rouge,42,"20, check the cv for: {'la': 1, 'plus': 2, 'associée': 4, 'est': 1, 'le': 1, 'rouge': 2}",11,40,"20, check the cv for: {'le': 1, 'vieux': 2, 'une': 2, 'grande': 3, 'voile': 3, 'rouge': 2}",8,2,3,"la   ku-l9-R   la   p-ly   a-so-s-je   a   la   ko-lE-R   e   l2   Ru-Z   ,check the cv for: {'la': 'la', 'plus': 'ply', 'associée': 'asosje', 'est': 'e', 'le': 'l2', 'rouge': 'RuZ'}","l2   v-j2   v-wa-l-je   po-sE-d   y-n   g-R@-d   v-wa-l   Ru-Z   ,check the cv for: {'le': 'l2', 'vieux': 'vj2', 'une': 'yn', 'grande': 'gR@d', 'voile': 'vwal', 'rouge': 'RuZ'}"
14,Les tensions entre les pays pourraient se transformer en guerre.,Dans de nombreux villages de l'ouest se préparait une guerre.,guerre,54,"22, check the cv for: {'les': 1, 'entre': 3, 'en': 1}",10,51,"18, except [""l'ouest""], check the cv for: {'de': 1, 'une': 2}",10,3,0,"le   t@-s-j§   @-t-R   le   pe-i   pu-RE   s2   t-R@-s-fO-R-me   @   gE-R   ,check the cv for: {'les': 'le', 'entre': '@tR', 'en': '@'}","d@   d2   n§-b-R2   vi-la-Z   d2   s2   p-Re-pa-RE   y-n   gE-R   ,except [""l'ouest""], check the phon for: {'de': 'd2', 'une': 'yn'}"
15,Gaspard était perdu et ne savait pas quoi faire.,Léo était choqué car c'était une chose bizarre à faire.,faire,39,"18, check the cv for: {'était': 2, 'perdu': 3, 'pas': 1, 'quoi': 2}",9,45,"16, except ['léo', ""c'était""], check the cv for: {'était': 2, 'choqué': 2, 'car': 2, 'une': 2}",10,-6,-1,"ga-s-pa-R   e-tE   pE-R-dy   e   n2   sa-vE   pa   k-wa   fE-R   ,check the cv for: {'était': 'etE', 'perdu': 'pERdy', 'pas': 'pa', 'quoi': 'kwa'}","e-tE   So-ke   ka-R   y-n   So-z   bi-za-R   a   fE-R   ,except ['léo', ""c'était""], check the phon for: {'était': 'etE', 'choqué': 'Soke', 'car': 'kaR', 'une': 'yn'}"
16,La mère inquiète avait plusieurs bouches à nourrir.,Il avait des animaux difficiles à nourrir.,nourrir,43,"20, check the cv for: {'la': 1, 'inquiète': 4, 'avait': 2, 'plusieurs': 5, 'bouches': 2}",8,35,"16, check the cv for: {'il': 2, 'avait': 2, 'animaux': 3}",7,8,1,"la   mE-R   5-k-jE-t   a-vE   p-ly-z-j9-R   bu-S   a   nu-Ri-R   ,check the cv for: {'la': 'la', 'inquiète': '5kjEt', 'avait': 'avE', 'plusieurs': 'plyzj9R', 'bouches': 'buS'}","i-l   a-vE   de   a-ni-mo   di-fi-si-l   a   nu-Ri-R   ,check the cv for: {'il': 'il', 'avait': 'avE', 'animaux': 'animo'}"
17,Arielle a été licenciée et a désespérément besoin d'un emploi.,Arthur a cherché et a rapidement retrouver un emploi.,emploi,52,"22, except ['arielle', ""d'un""], check the cv for: {'a': 1, 'été': 2, 'licenciée': 4}",10,44,"11, except ['arthur', 'rapidement', 'retrouver'], check the cv for: {'a': 1, 'un': 1}",9,8,1,"a   e-te   li-s@-s-je   e   a   de-zE-s-pe-Re-m@   b2-z-w5   @-p-l-wa   ,except ['arielle', ""d'un""], check the phon for: {'a': 'a', 'été': 'ete', 'licenciée': 'lis@sje'}","a   SE-R-Se   e   a   1   @-p-l-wa   ,except ['arthur', 'rapidement', 'retrouver'], check the phon for: {'a': 'a', 'un': '1'}"
18,"En cuisinant, Luc s'est accidentellement coupé avec un couteau.","En rentrant, Chloé trouva sur la table son ancien couteau.",couteau,53,"13, except ['luc', ""s'est"", 'accidentellement'], check the cv for: {'en': 1, 'coupé': 2, 'un': 1}",9,47,"19, except ['chloé'], check the cv for: {'en': 1, 'rentrant': 3, 'sur': 2, 'la': 1, 'table': 3, 'son': 1, 'ancien': 3}",10,6,-1,"@   k-8i-zi-n@   ku-pe   a-vE-k   1   ku-to   ,except ['luc', ""s'est"", 'accidentellement'], check the phon for: {'en': '@', 'coupé': 'kupe', 'un': '1'}","@   R@-t-R@   t-Ru-va   sy-R   la   ta-b-l   s§   @-s-j5   ku-to   ,except ['chloé'], check the phon for: {'en': '@', 'rentrant': 'R@tR@', 'sur': 'syR', 'la': 'la', 'table': 'tabl', 'son': 's§', 'ancien': '@sj5'}"
19,Gille préfère les films drôles qui le font rire.,Alice lit un livre qui la fait rire.,rire,39,"16, except ['gille'], check the cv for: {'les': 1, 'drôles': 3, 'qui': 1, 'le': 1, 'rire': 2}",9,28,"10, except ['alice'], check the cv for: {'lit': 1, 'un': 1, 'livre': 3, 'qui': 1, 'la': 1, 'fait': 1, 'rire': 2}",8,11,1,"p-Re-fE-R   le   fi-l-m   d-Ro-l   ki   l2   f§   Ri-R   ,except ['gille'], check the phon for: {'les': 'le', 'drôles': 'dRol', 'qui': 'ki', 'le': 'l2', 'rire': 'RiR'}","li   1   li-v-R   ki   la   fE   Ri-R   ,except ['alice'], check the phon for: {'lit': 'li', 'un': '1', 'livre': 'livR', 'qui': 'ki', 'la': 'la', 'fait': 'fE', 'rire': 'RiR'}"
20,"Après avoir soumis le papier, Lucie a réalisé qu'elle avait fait une erreur.","Avant de lui répondre, Louis a regardé si le document comportait une erreur.",erreur,62,"26, except ['lucie', ""qu'elle""], check the cv for: {'après': 3, 'avoir': 4, 'soumis': 2, 'le': 1, 'a': 1, 'réalisé': 4, 'avait': 2, 'fait': 1, 'une': 2}",13,62,"26, except ['regardé'], check the cv for: {'avant': 2, 'de': 1, 'lui': 2, 'louis': 2, 'a': 1, 'si': 1, 'le': 1, 'une': 2}",13,0,0,"a-p-RE   a-v-wa-R   su-mi   l2   pa-p-je   a   Re-a-li-ze   a-vE   fE   y-n   E-R9-R   ,except ['lucie', ""qu'elle""], check the phon for: {'après': 'apRE', 'avoir': 'avwaR', 'soumis': 'sumi', 'le': 'l2', 'a': 'a', 'réalisé': 'Realize', 'avait': 'avE', 'fait': 'fE', 'une': 'yn'}","a-v@   d2   l-8i   Re-p§-d-R   l-wi   a   si   l2   do-ky-m@   k§-pO-R-tE   y-n   E-R9-R   ,except ['regardé'], check the phon for: {'avant': 'av@', 'de': 'd2', 'lui': 'l8i', 'louis': 'lwi', 'a': 'a', 'si': 'si', 'le': 'l2', 'une': 'yn'}"
21,"Selon la Bible, le meurtre est un péché.","Dans leur culture, le mensonge est un péché.",péché,31,"13, except ['selon'], check the cv for: {'la': 1, 'le': 1, 'est': 1, 'un': 1, 'péché': 2}",8,35,"15, check the cv for: {'leur': 2, 'le': 1, 'est': 1, 'un': 1, 'péché': 2}",8,-4,0,"la   bi-b-l   l2   m9-R-t-R   e   1   pe-Se   ,except ['selon'], check the phon for: {'la': 'la', 'le': 'l2', 'est': 'e', 'un': '1', 'péché': 'peSe'}","d@   l9-R   ky-l-ty-R   l2   m@-s§-Z   e   1   pe-Se   ,check the cv for: {'leur': 'l9R', 'le': 'l2', 'est': 'e', 'un': '1', 'péché': 'peSe'}"
22,"Après s'être lavé les mains, Kevin les a séchées avec une serviette.","Après le tournoi de tennis, Nathan lui a donné une petite serviette.",serviette,55,"21, except [""s'être"", 'kevin'], check the cv for: {'après': 3, 'lavé': 2, 'les': 1, 'a': 1, 'une': 2}",12,55,"24, except ['nathan', 'petite'], check the cv for: {'après': 3, 'le': 1, 'de': 1, 'lui': 2, 'a': 1, 'donné': 2, 'une': 2}",12,0,0,"a-p-RE   la-ve   le   m5   le   a   se-Se   a-vE-k   y-n   sE-R-v-jE-t   ,except [""s'être"", 'kevin'], check the phon for: {'après': 'apRE', 'lavé': 'lave', 'les': 'le', 'a': 'a', 'une': 'yn'}","a-p-RE   l2   tu-R-n-wa   d2   te-ni-s   l-8i   a   do-ne   y-n   sE-R-v-jE-t   ,except ['nathan', 'petite'], check the phon for: {'après': 'apRE', 'le': 'l2', 'de': 'd2', 'lui': 'l8i', 'a': 'a', 'donné': 'done', 'une': 'yn'}"
23,Les hommes ont failli tomber dans le trou qu'ils avaient creusé.,Les soldats passaient toujours par le chemin qu'ils avaient creusé.,creusé,53,"17, except [""qu'ils""], check the cv for: {'les': 1, 'ont': 1, 'failli': 2, 'le': 1, 'avaient': 2}",11,57,"17, except ['chemin', ""qu'ils""], check the cv for: {'les': 1, 'par': 2, 'le': 1, 'avaient': 2}",10,-4,1,"le   O-m   §   fa-ji   t§-be   d@   l2   t-Ru   a-vE   k-R2-ze   ,except [""qu'ils""], check the phon for: {'les': 'le', 'ont': '§', 'failli': 'faji', 'le': 'l2', 'avaient': 'avE'}","le   sO-l-da   pa-sE   tu-Zu-R   pa-R   l2   a-vE   k-R2-ze   ,except ['chemin', ""qu'ils""], check the phon for: {'les': 'le', 'par': 'paR', 'le': 'l2', 'avaient': 'avE'}"
24,La fille qui a perdu s'est plaint que la compétition n'était pas juste.,La femme qui vient d'arriver pense que cette organisation n'est pas juste.,juste,58,"21, except [""s'est"", ""n'était""], check the cv for: {'la': 1, 'qui': 1, 'a': 1, 'perdu': 3, 'que': 1, 'pas': 1, 'juste': 3}",13,62,"22, except [""d'arriver"", ""n'est""], check the cv for: {'la': 1, 'qui': 1, 'que': 1, 'pas': 1, 'juste': 3}",12,-4,1,"la   fi-j   ki   a   pE-R-dy   p-l5   k2   la   k§-pe-ti-s-j§   pa   Zy-s-t   ,except [""s'est"", ""n'était""], check the phon for: {'la': 'la', 'qui': 'ki', 'a': 'a', 'perdu': 'pERdy', 'que': 'k2', 'pas': 'pa', 'juste': 'Zyst'}","la   fa-m   ki   v-j5   p@-s   k2   sE-t   O-R-ga-ni-za-s-j§   pa   Zy-s-t   ,except [""d'arriver"", ""n'est""], check the phon for: {'la': 'la', 'qui': 'ki', 'que': 'k2', 'pas': 'pa', 'juste': 'Zyst'}"
25,Chris dit que son chien avait toujours été son meilleur ami.,Julia avait toujours aimé se promener avec son ami.,ami,49,"19, except ['chris'], check the cv for: {'dit': 1, 'que': 1, 'son': 1, 'avait': 2, 'été': 2, 'meilleur': 4, 'ami': 2}",11,42,"18, except ['julia'], check the cv for: {'avait': 2, 'aimé': 2, 'son': 1, 'ami': 2}",9,7,2,"di   k2   s§   S-j5   a-vE   tu-Zu-R   e-te   s§   mE-j-9-R   a-mi   ,except ['chris'], check the phon for: {'dit': 'di', 'que': 'k2', 'son': 's§', 'avait': 'avE', 'été': 'ete', 'meilleur': 'mEj9R', 'ami': 'ami'}","a-vE   tu-Zu-R   e-me   s2   p-RO-m-ne   a-vE-k   s§   a-mi   ,except ['julia'], check the phon for: {'avait': 'avE', 'aimé': 'eme', 'son': 's§', 'ami': 'ami'}"
26,Ils ont cherché le voleur mais il avait déjà disparu.,Elles étaient venu voir le maire mais il avait encore disparu.,parti/disparu,43,"21, check the cv for: {'ont': 1, 'le': 1, 'voleur': 3, 'mais': 1, 'il': 2, 'avait': 2, 'déjà': 2, 'disparu': 4}",10,51,"22, except ['venu'], check the cv for: {'étaient': 2, 'le': 1, 'mais': 1, 'il': 2, 'avait': 2, 'disparu': 4}",11,-8,-1,"i-l   §   SE-R-Se   l2   vo-l9-R   mE   i-l   a-vE   de-Za   di-s-pa-Ry   ,check the cv for: {'ont': '§', 'le': 'l2', 'voleur': 'vol9R', 'mais': 'mE', 'il': 'il', 'avait': 'avE', 'déjà': 'deZa', 'disparu': 'dispaRy'}","E-l   e-tE   v-wa-R   l2   mE-R   mE   i-l   a-vE   @-kO-R   di-s-pa-Ry   ,except ['venu'], check the phon for: {'étaient': 'etE', 'le': 'l2', 'mais': 'mE', 'il': 'il', 'avait': 'avE', 'disparu': 'dispaRy'}"
27,Eric avait acheté son chien alors que celui-ci était encore un chiot.,Romain est parti en vacances alors qu'il vient d'acheter un chiot.,chiot,57,"18, except ['eric', 'acheté', 'celui'], check the cv for: {'avait': 2, 'son': 1, 'que': 1, 'était': 2, 'un': 1}",13,55,"18, except [""qu'il"", ""d'acheter""], check the cv for: {'romain': 2, 'est': 1, 'parti': 3, 'en': 1, 'un': 1}",11,2,2,"a-vE   s§   S-j5   a-lO-R   k2   si   e-tE   @-kO-R   1   S-jo   ,except ['eric', 'acheté', 'celui'], check the phon for: {'avait': 'avE', 'son': 's§', 'que': 'k2', 'était': 'etE', 'un': '1'}","Ro-m5   e   pa-R-ti   @   va-k@-s   a-lO-R   v-j5   1   S-jo   ,except [""qu'il"", ""d'acheter""], check the phon for: {'romain': 'Rom5', 'est': 'e', 'parti': 'paRti', 'en': '@', 'un': '1'}"
28,Lisa a dit que la valise semblait peser une tonne.,Pablo pense que cet espace peut en stocker une tonne.,tonne,40,"16, except ['lisa'], check the cv for: {'a': 1, 'dit': 1, 'que': 1, 'la': 1, 'une': 2, 'tonne': 2}",10,43,"18, except ['pablo'], check the cv for: {'que': 1, 'espace': 4, 'en': 1, 'une': 2, 'tonne': 2}",10,-3,0,"a   di   k2   la   va-li-z   s@-b-lE   p2-ze   y-n   tO-n   ,except ['lisa'], check the phon for: {'a': 'a', 'dit': 'di', 'que': 'k2', 'la': 'la', 'une': 'yn', 'tonne': 'tOn'}","p@-s   k2   sE-t   E-s-pa-s   p2   @   s-to-ke   y-n   tO-n   ,except ['pablo'], check the phon for: {'que': 'k2', 'espace': 'Espas', 'en': '@', 'une': 'yn', 'tonne': 'tOn'}"
29,Personne n'a ri parce qu'ils n'avaient pas compris la blague.,Elle ne l'écoutait plus car il racontait la même blague.,blague,51,"16, except [""n'a"", ""qu'ils"", ""n'avaient""], check the cv for: {'personne': 4, 'ri': 1, 'pas': 1, 'compris': 3, 'la': 1, 'blague': 3}",10,46,"18, except [""l'écoutait""], check the cv for: {'plus': 2, 'car': 2, 'il': 2, 'la': 1, 'même': 2, 'blague': 3}",10,5,0,"pE-R-sO-n   Ri   pa-R-s   pa   k§-p-Ri   la   b-la-g   ,except [""n'a"", ""qu'ils"", ""n'avaient""], check the phon for: {'personne': 'pERsOn', 'ri': 'Ri', 'pas': 'pa', 'compris': 'k§pRi', 'la': 'la', 'blague': 'blag'}","E-l   n2   p-ly   ka-R   i-l   Ra-k§-tE   la   mE-m   b-la-g   ,except [""l'écoutait""], check the phon for: {'plus': 'ply', 'car': 'kaR', 'il': 'il', 'la': 'la', 'même': 'mEm', 'blague': 'blag'}"
30,Le visage du bébé s'est crispé quand il a mangé quelque chose d'acide.,Les invités étaient surpris quand il leur a servi un plat acide.,acide,57,"22, except [""s'est"", ""d'acide""], check the cv for: {'le': 1, 'quand': 1, 'il': 2, 'a': 1, 'quelque': 3}",13,52,"25, check the cv for: {'les': 1, 'invités': 3, 'étaient': 2, 'surpris': 4, 'quand': 1, 'il': 2, 'leur': 2, 'a': 1, 'servi': 3, 'un': 1, 'plat': 2, 'acide': 3}",12,5,1,"l2   vi-za-Z   dy   be-be   k-Ri-s-pe   k@   i-l   a   m@-Ze   kE-l-k   So-z   ,except [""s'est"", ""d'acide""], check the phon for: {'le': 'l2', 'quand': 'k@', 'il': 'il', 'a': 'a', 'quelque': 'kElk'}","le   5-vi-te   e-tE   sy-R-p-Ri   k@   i-l   l9-R   a   sE-R-vi   1   p-la   a-si-d   ,check the cv for: {'les': 'le', 'invités': '5vite', 'étaient': 'etE', 'surpris': 'syRpRi', 'quand': 'k@', 'il': 'il', 'leur': 'l9R', 'a': 'a', 'servi': 'sERvi', 'un': '1', 'plat': 'pla', 'acide': 'asid'}"
31,Le pêcheur a facilement mis l'appât sur l'hameçon.,L'étudiant est rapidement allé s'acheter un nouvel hameçon.,hameçon,42,"8, except ['facilement', ""l'appât"", ""l'hameçon""], check the cv for: {'le': 1, 'a': 1, 'mis': 1, 'sur': 2}",8,51,"7, except [""l'étudiant"", 'rapidement', ""s'acheter"", 'hameçon'], check the cv for: {'est': 1, 'un': 1}",8,-9,0,"l2   pE-S9-R   a   mi   sy-R   ,except ['facilement', ""l'appât"", ""l'hameçon""], check the phon for: {'le': 'l2', 'a': 'a', 'mis': 'mi', 'sur': 'syR'}","e   a-le   1   nu-vE-l   ,except [""l'étudiant"", 'rapidement', ""s'acheter"", 'hameçon'], check the phon for: {'est': 'e', 'un': '1'}"
32,Claire a emménagé dans son appartement peu après avoir signé le contrat.,Sacha a vite demandé un rendez-vous après avoir relu son contrat.,contrat/bail,60,"24, except ['appartement'], check the cv for: {'claire': 3, 'a': 1, 'son': 1, 'peu': 1, 'après': 3, 'avoir': 4, 'signé': 2, 'le': 1}",12,54,"18, except ['sacha', 'demandé', 'relu'], check the cv for: {'a': 1, 'vite': 2, 'un': 1, 'après': 3, 'avoir': 4, 'son': 1}",12,6,0,"k-lE-R   a   @-me-na-Ze   d@   s§   p2   a-p-RE   a-v-wa-R   si-Ne   l2   k§-t-Ra   ,except ['appartement'], check the phon for: {'claire': 'klER', 'a': 'a', 'son': 's§', 'peu': 'p2', 'après': 'apRE', 'avoir': 'avwaR', 'signé': 'siNe', 'le': 'l2'}","a   vi-t   1   R@-de   vu   a-p-RE   a-v-wa-R   s§   k§-t-Ra   ,except ['sacha', 'demandé', 'relu'], check the phon for: {'a': 'a', 'vite': 'vit', 'un': '1', 'après': 'apRE', 'avoir': 'avwaR', 'son': 's§'}"
33,"Sales et usées, les bottes de pluie étaient couvertes de boue.","Nettoyé et rangé, le balcon ne comportait plus de traces de boue.",boue,50,"20, check the cv for: {'sales': 2, 'usées': 2, 'les': 1, 'bottes': 2, 'de': 1, 'étaient': 2, 'couvertes': 4}",11,52,"24, check the cv for: {'rangé': 2, 'le': 1, 'plus': 2, 'de': 1, 'traces': 3}",12,-2,-1,"sa-l   e   y-ze   le   bO-t   d2   p-l-8i   e-tE   ku-vE-R-t   d2   bu   ,check the cv for: {'sales': 'sal', 'usées': 'yze', 'les': 'le', 'bottes': 'bOt', 'de': 'd2', 'étaient': 'etE', 'couvertes': 'kuvERt'}","ne-t-wa-je   e   R@-Ze   l2   ba-l-k§   n2   k§-pO-R-tE   p-ly   d2   t-Ra-s   d2   bu   ,check the cv for: {'rangé': 'R@Ze', 'le': 'l2', 'plus': 'ply', 'de': 'd2', 'traces': 'tRas'}"
34,Le policier est entré dans le bâtiment et a montré son badge.,L'enfant a perdu la course mais a reçu un badge.,badge,49,"23, check the cv for: {'le': 1, 'policier': 4, 'est': 1, 'a': 1, 'son': 1}",12,38,"14, except [""l'enfant"", 'reçu'], check the cv for: {'a': 1, 'perdu': 3, 'la': 1, 'course': 3, 'mais': 1, 'un': 1}",10,11,2,"l2   po-li-s-je   e   @-t-Re   d@   l2   ba-ti-m@   e   a   m§-t-Re   s§   ba-d-Z   ,check the cv for: {'le': 'l2', 'policier': 'polisje', 'est': 'e', 'a': 'a', 'son': 's§'}","a   pE-R-dy   la   ku-R-s   mE   a   1   ba-d-Z   ,except [""l'enfant"", 'reçu'], check the phon for: {'a': 'a', 'perdu': 'pERdy', 'la': 'la', 'course': 'kuRs', 'mais': 'mE', 'un': '1'}"
35,L'événement de déstockage dans tout le magasin a attiré une immense foule.,La boutique d'antiquité était dans une rue épargnée par la foule.,foule,62,"23, except [""l'événement""], check the cv for: {'de': 1, 'tout': 1, 'le': 1, 'a': 1, 'une': 2, 'foule': 2}",12,54,"19, except [""d'antiquité""], check the cv for: {'la': 1, 'était': 2, 'une': 2, 'rue': 1, 'par': 2, 'foule': 2}",11,8,1,"d2   de-s-tO-ka-Z   d@   tu   l2   ma-ga-z5   a   a-ti-Re   y-n   i-m@-s   fu-l   ,except [""l'événement""], check the phon for: {'de': 'd2', 'tout': 'tu', 'le': 'l2', 'a': 'a', 'une': 'yn', 'foule': 'ful'}","la   bu-ti-k   e-tE   d@   y-n   Ry   e-pa-R-Ne   pa-R   la   fu-l   ,except [""d'antiquité""], check the phon for: {'la': 'la', 'était': 'etE', 'une': 'yn', 'rue': 'Ry', 'par': 'paR', 'foule': 'ful'}"
36,Manon était triste de voir que son poisson rouge était mort.,Dina était surprise d'appendre que Valentin était mort.,mort,49,"21, except ['manon'], check the cv for: {'était': 2, 'de': 1, 'que': 1, 'son': 1, 'rouge': 2, 'mort': 2}",11,47,"15, except ['dina', ""d'appendre""], check the cv for: {'était': 2, 'surprise': 5, 'que': 1, 'mort': 2}",8,2,3,"e-tE   t-Ri-s-t   d2   v-wa-R   k2   s§   p-wa-s§   Ru-Z   e-tE   mO-R   ,except ['manon'], check the phon for: {'était': 'etE', 'de': 'd2', 'que': 'k2', 'son': 's§', 'rouge': 'RuZ', 'mort': 'mOR'}","e-tE   sy-R-p-Ri-z   k2   va-l@-t5   e-tE   mO-R   ,except ['dina', ""d'appendre""], check the phon for: {'était': 'etE', 'surprise': 'syRpRiz', 'que': 'k2', 'mort': 'mOR'}"
37,Elle a dit à son petit ami barbu qu'il devait se raser.,Elle a dit à son frère qu'il devait vraiment se raser.,raser,43,"14, except ['petit', ""qu'il"", 'devait'], check the cv for: {'a': 1, 'dit': 1, 'son': 1, 'ami': 2, 'barbu': 3}",12,43,"15, except [""qu'il"", 'devait'], check the cv for: {'a': 1, 'dit': 1, 'son': 1}",11,0,1,"E-l   a   di   a   s§   a-mi   ba-R-by   s2   Ra-ze   ,except ['petit', ""qu'il"", 'devait'], check the phon for: {'a': 'a', 'dit': 'di', 'son': 's§', 'ami': 'ami', 'barbu': 'baRby'}","E-l   a   di   a   s§   f-RE-R   v-RE-m@   s2   Ra-ze   ,except [""qu'il"", 'devait'], check the phon for: {'a': 'a', 'dit': 'di', 'son': 's§'}"
38,L'enseignant avait peur des microbes et de tomber malade.,Il est venu dans la chambre et est maintenant malade.,malade,48,"16, except [""l'enseignant""], check the cv for: {'avait': 2, 'de': 1, 'malade': 3}",9,43,"13, except ['venu', 'maintenant'], check the cv for: {'il': 2, 'est': 1, 'la': 1, 'chambre': 3, 'malade': 3}",10,5,-1,"a-vE   p2-R   de   mi-k-RO-b   e   d2   t§-be   ma-la-d   ,except [""l'enseignant""], check the phon for: {'avait': 'avE', 'de': 'd2', 'malade': 'malad'}","i-l   e   d@   la   S@-b-R   e   e   ma-la-d   ,except ['venu', 'maintenant'], check the phon for: {'il': 'il', 'est': 'e', 'la': 'la', 'chambre': 'S@bR', 'malade': 'malad'}"
39,Il avait donné vingt euros après avoir perdu le pari.,Il est parti en vacances après avoir gagner un pari.,pari,43,"22, check the cv for: {'il': 2, 'avait': 2, 'donné': 2, 'après': 3, 'avoir': 4, 'perdu': 3, 'le': 1}",10,42,"22, check the cv for: {'il': 2, 'est': 1, 'parti': 3, 'en': 1, 'après': 3, 'avoir': 4, 'un': 1}",10,1,0,"i-l   a-vE   do-ne   v5   2-Ro   a-p-RE   a-v-wa-R   pE-R-dy   l2   pa-Ri   ,check the cv for: {'il': 'il', 'avait': 'avE', 'donné': 'done', 'après': 'apRE', 'avoir': 'avwaR', 'perdu': 'pERdy', 'le': 'l2'}","i-l   e   pa-R-ti   @   va-k@-s   a-p-RE   a-v-wa-R   ga-Ne   1   pa-Ri   ,check the cv for: {'il': 'il', 'est': 'e', 'parti': 'paRti', 'en': '@', 'après': 'apRE', 'avoir': 'avwaR', 'un': '1'}"
40,Albert vivait dans une hutte en chaume qu'il avait lui-même construite.,Hugo regardait la grande fontaine que sa grand-mère avait construite.,construite,60,"22, except ['albert', ""qu'il""], check the cv for: {'une': 2, 'en': 1, 'avait': 2, 'lui': 2, 'même': 2}",12,59,"21, except ['hugo', 'regardait'], check the cv for: {'la': 1, 'grande': 3, 'que': 1, 'sa': 1, 'grand': 2, 'avait': 2}",11,1,1,"vi-vE   d@   y-n   y-t   @   So-m   a-vE   l-8i   mE-m   k§-s-t-R-8i-t   ,except ['albert', ""qu'il""], check the phon for: {'une': 'yn', 'en': '@', 'avait': 'avE', 'lui': 'l8i', 'même': 'mEm'}","la   g-R@-d   f§-tE-n   k2   sa   g-R@   mE-R   a-vE   k§-s-t-R-8i-t   ,except ['hugo', 'regardait'], check the phon for: {'la': 'la', 'grande': 'gR@d', 'que': 'k2', 'sa': 'sa', 'grand': 'gR@', 'avait': 'avE'}"
41,Le randonneur ne savait pas qu'il avait marché si loin.,La dame supposait qu'ils étaient allé trop loin.,loin,45,"17, except [""qu'il""], check the cv for: {'le': 1, 'pas': 1, 'avait': 2, 'marché': 3, 'si': 1}",10,40,"14, except [""qu'ils""], check the cv for: {'la': 1, 'dame': 2, 'étaient': 2}",8,5,2,"l2   R@-do-n9-R   n2   sa-vE   pa   a-vE   ma-R-Se   si   l-w5   ,except [""qu'il""], check the phon for: {'le': 'l2', 'pas': 'pa', 'avait': 'avE', 'marché': 'maRSe', 'si': 'si'}","la   da-m   sy-po-zE   e-tE   a-le   t-Ro   l-w5   ,except [""qu'ils""], check the phon for: {'la': 'la', 'dame': 'dam', 'étaient': 'etE'}"
42,"Avec des vêtements éparpillés partout, sa chambre était en désordre.","Après l'élection municipale, toute la ville était en désordre.",désordre,57,"24, except ['vêtements'], check the cv for: {'éparpillés': 5, 'sa': 1, 'chambre': 3, 'était': 2, 'en': 1}",10,52,"21, except [""l'élection""], check the cv for: {'après': 3, 'toute': 2, 'la': 1, 'était': 2, 'en': 1}",9,5,1,"a-vE-k   de   e-pa-R-pi-je   pa-R-tu   sa   S@-b-R   e-tE   @   de-zO-R-d-R   ,except ['vêtements'], check the phon for: {'éparpillés': 'epaRpije', 'sa': 'sa', 'chambre': 'S@bR', 'était': 'etE', 'en': '@'}","a-p-RE   my-ni-si-pa-l   tu-t   la   vi-l   e-tE   @   de-zO-R-d-R   ,except [""l'élection""], check the phon for: {'après': 'apRE', 'toute': 'tut', 'la': 'la', 'était': 'etE', 'en': '@'}"
43,Thomas a ouvert la porte après avoir tiré de toutes ses forces.,Emma est entrée après avoir rassemblé ses dernières forces.,forces,51,"26, check the cv for: {'a': 1, 'ouvert': 3, 'la': 1, 'porte': 3, 'après': 3, 'avoir': 4, 'tiré': 2, 'de': 1, 'toutes': 2, 'ses': 1, 'forces': 3}",12,50,"24, except ['emma'], check the cv for: {'est': 1, 'entrée': 3, 'après': 3, 'avoir': 4, 'ses': 1, 'dernières': 5, 'forces': 3}",9,1,3,"to-ma   a   u-vE-R   la   pO-R-t   a-p-RE   a-v-wa-R   ti-Re   d2   tu-t   se   fO-R-s   ,check the cv for: {'a': 'a', 'ouvert': 'uvER', 'la': 'la', 'porte': 'pORt', 'après': 'apRE', 'avoir': 'avwaR', 'tiré': 'tiRe', 'de': 'd2', 'toutes': 'tut', 'ses': 'se', 'forces': 'fORs'}","e   @-t-Re   a-p-RE   a-v-wa-R   Ra-s@-b-le   se   dE-R-n-jE-R   fO-R-s   ,except ['emma'], check the phon for: {'est': 'e', 'entrée': '@tRe', 'après': 'apRE', 'avoir': 'avwaR', 'ses': 'se', 'dernières': 'dERnjER', 'forces': 'fORs'}"
44,Robert pourrait réparer le vélo s'il avait les bons outils.,Elle doit encore apprendre à utiliser les bons outils.,outils,49,"17, except [""s'il""], check the cv for: {'le': 1, 'avait': 2, 'les': 1, 'bons': 1}",10,45,"21, check the cv for: {'doit': 2, 'les': 1, 'bons': 1}",9,4,1,"Ro-bE-R   pu-RE   Re-pa-Re   l2   ve-lo   a-vE   le   b§   u-ti   ,except [""s'il""], check the phon for: {'le': 'l2', 'avait': 'avE', 'les': 'le', 'bons': 'b§'}","E-l   d-wa   @-kO-R   a-p-R@-d-R   a   y-ti-li-ze   le   b§   u-ti   ,check the cv for: {'doit': 'dwa', 'les': 'le', 'bons': 'b§'}"
45,"Après trois semaines, il y avait une pile de vêtements sales à laver.","Après quelques mois, ils ont recruté un homme pour tout laver.",laver,55,"21, except ['semaines', 'vêtements'], check the cv for: {'après': 3, 'il': 2, 'y': 1, 'avait': 2, 'une': 2, 'pile': 2, 'de': 1, 'sales': 2}",13,50,"19, except ['recruté'], check the cv for: {'après': 3, 'ont': 1, 'un': 1, 'pour': 2, 'tout': 1}",11,5,2,"a-p-RE   t-R-wa   i-l   i   a-vE   y-n   pi-l   d2   sa-l   a   la-ve   ,except ['semaines', 'vêtements'], check the phon for: {'après': 'apRE', 'il': 'il', 'y': 'i', 'avait': 'avE', 'une': 'yn', 'pile': 'pil', 'de': 'd2', 'sales': 'sal'}","a-p-RE   kE-l-k   m-wa   i-l   §   1   O-m   pu-R   tu   la-ve   ,except ['recruté'], check the phon for: {'après': 'apRE', 'ont': '§', 'un': '1', 'pour': 'puR', 'tout': 'tu'}"
46,Daniel était contrarié que son équipe de basket n'ait pas gagné.,Camille était troublée qu'on lui dise qu'elle avait gagné.,gagné,53,"20, except ['daniel', ""n'ait""], check the cv for: {'était': 2, 'contrarié': 5, 'que': 1, 'son': 1, 'équipe': 3, 'de': 1, 'pas': 1, 'gagné': 2}",11,49,"14, except ['camille', ""qu'on"", ""qu'elle""], check the cv for: {'était': 2, 'troublée': 4, 'lui': 2, 'avait': 2, 'gagné': 2}",9,4,2,"e-tE   k§-t-Ra-R-je   k2   s§   e-ki-p   d2   ba-s-kE-t   pa   ga-Ne   ,except ['daniel', ""n'ait""], check the phon for: {'était': 'etE', 'contrarié': 'k§tRaRje', 'que': 'k2', 'son': 's§', 'équipe': 'ekip', 'de': 'd2', 'pas': 'pa', 'gagné': 'gaNe'}","e-tE   t-Ru-b-le   l-8i   di-z   a-vE   ga-Ne   ,except ['camille', ""qu'on"", ""qu'elle""], check the phon for: {'était': 'etE', 'troublée': 'tRuble', 'lui': 'l8i', 'avait': 'avE', 'gagné': 'gaNe'}"
47,L'enfant a pleuré quand elle a été piquée par une abeille.,Le visiteur était content quand il a deviné l'espèce de l'abeille.,abeille,47,"19, except [""l'enfant""], check the cv for: {'a': 1, 'quand': 1, 'été': 2, 'piquée': 2, 'par': 2, 'une': 2}",11,55,"14, except ['deviné', ""l'espèce"", ""l'abeille""], check the cv for: {'le': 1, 'était': 2, 'content': 2, 'quand': 1, 'il': 2, 'a': 1, 'de': 1}",11,-8,0,"a   p-l9-Re   k@   E-l   a   e-te   pi-ke   pa-R   y-n   a-bE-j   ,except [""l'enfant""], check the phon for: {'a': 'a', 'quand': 'k@', 'été': 'ete', 'piquée': 'pike', 'par': 'paR', 'une': 'yn'}","l2   vi-zi-t9-R   e-tE   k§-t@   k@   i-l   a   d2   ,except ['deviné', ""l'espèce"", ""l'abeille""], check the phon for: {'le': 'l2', 'était': 'etE', 'content': 'k§t@', 'quand': 'k@', 'il': 'il', 'a': 'a', 'de': 'd2'}"
48,Le pêcheur aimait passer ses journées sur son bateau.,L'équipe s'est entrainée de longues semaines sur son bateau.,bateau,44,"17, check the cv for: {'le': 1, 'passer': 2, 'ses': 1, 'sur': 2, 'son': 1}",9,51,"8, except [""l'équipe"", ""s'est"", 'entrainée', 'semaines'], check the cv for: {'de': 1, 'longues': 2, 'sur': 2, 'son': 1}",9,-7,0,"l2   pE-S9-R   E-mE   pa-se   se   Zu-R-ne   sy-R   s§   ba-to   ,check the cv for: {'le': 'l2', 'passer': 'pase', 'ses': 'se', 'sur': 'syR', 'son': 's§'}","d2   l§-g   sy-R   s§   ba-to   ,except [""l'équipe"", ""s'est"", 'entrainée', 'semaines'], check the phon for: {'de': 'd2', 'longues': 'l§g', 'sur': 'syR', 'son': 's§'}"
49,La petite fille a trébuché et s'est immédiatement mise à pleurer.,Le petit garçon était assis et s'est tout d'un coup mis à pleurer.,pleurer,54,"15, except ['petite', ""s'est"", 'immédiatement'], check the cv for: {'la': 1, 'a': 1, 'mise': 2}",11,53,"16, except ['petit', ""s'est"", ""d'un""], check the cv for: {'le': 1, 'était': 2, 'assis': 2, 'tout': 1, 'mis': 1}",13,1,-2,"la   fi-j   a   t-Re-by-Se   e   mi-z   a   p-l2-Re   ,except ['petite', ""s'est"", 'immédiatement'], check the phon for: {'la': 'la', 'a': 'a', 'mise': 'miz'}","l2   ga-R-s§   e-tE   a-si   e   tu   ku   mi   a   p-l2-Re   ,except ['petit', ""s'est"", ""d'un""], check the phon for: {'le': 'l2', 'était': 'etE', 'assis': 'asi', 'tout': 'tu', 'mis': 'mi'}"
50,"Pour honorer la mort de son collègue, Kim a assisté à son enterrement.","Pour aider la famille de sa femme, Diego a organisé l'enterrement.",enterrement,56,"20, except ['kim', 'enterrement'], check the cv for: {'pour': 2, 'la': 1, 'mort': 2, 'de': 1, 'son': 1, 'a': 1, 'assisté': 4}",13,54,"18, except ['diego', ""l'enterrement""], check the cv for: {'pour': 2, 'la': 1, 'de': 1, 'sa': 1, 'a': 1, 'organisé': 5}",11,2,2,"pu-R   o-no-Re   la   mO-R   d2   s§   ko-lE-g   a   a-si-s-te   a   s§   ,except ['kim', 'enterrement'], check the phon for: {'pour': 'puR', 'la': 'la', 'mort': 'mOR', 'de': 'd2', 'son': 's§', 'a': 'a', 'assisté': 'asiste'}","pu-R   e-de   la   fa-mi-j   d2   sa   fa-m   a   O-R-ga-ni-ze   ,except ['diego', ""l'enterrement""], check the phon for: {'pour': 'puR', 'la': 'la', 'de': 'd2', 'sa': 'sa', 'a': 'a', 'organisé': 'ORganize'}"
51,Le nouveau président estime que personne ne devrait vivre dans la pauvreté.,L'homme lui a dit que son enfance s'était déroulée dans la pauvreté.,pauvreté,63,"22, except ['devrait', 'pauvreté'], check the cv for: {'le': 1, 'nouveau': 2, 'président': 4, 'estime': 4, 'que': 1, 'personne': 4, 'vivre': 3, 'la': 1}",12,56,"14, except [""l'homme"", ""s'était"", 'pauvreté'], check the cv for: {'lui': 2, 'a': 1, 'dit': 1, 'que': 1, 'son': 1, 'la': 1}",12,7,0,"l2   nu-vo   p-Re-zi-d@   E-s-ti-m   k2   pE-R-sO-n   n2   vi-v-R   d@   la   ,except ['devrait', 'pauvreté'], check the phon for: {'le': 'l2', 'nouveau': 'nuvo', 'président': 'pRezid@', 'estime': 'Estim', 'que': 'k2', 'personne': 'pERsOn', 'vivre': 'vivR', 'la': 'la'}","l-8i   a   di   k2   s§   @-f@-s   de-Ru-le   d@   la   ,except [""l'homme"", ""s'était"", 'pauvreté'], check the phon for: {'lui': 'l8i', 'a': 'a', 'dit': 'di', 'que': 'k2', 'son': 's§', 'la': 'la'}"
52,"Dans de nombreuses phrases, le nom est suivi d'un verbe.","Dans cette phrase, la parenthèse est suivie d'un verbe.",verbe,45,"18, except [""d'un""], check the cv for: {'de': 1, 'phrases': 3, 'le': 1, 'est': 1, 'suivi': 3}",10,45,"18, except [""d'un""], check the cv for: {'phrase': 3, 'la': 1, 'est': 1, 'suivie': 3}",9,0,1,"d@   d2   n§-b-R2-z   f-Ra-z   l2   n§   e   s-8i-vi   vE-R-b   ,except [""d'un""], check the phon for: {'de': 'd2', 'phrases': 'fRaz', 'le': 'l2', 'est': 'e', 'suivi': 's8ivi'}","d@   sE-t   f-Ra-z   la   pa-R@-tE-z   e   s-8i-vi   vE-R-b   ,except [""d'un""], check the phon for: {'phrase': 'fRaz', 'la': 'la', 'est': 'e', 'suivie': 's8ivi'}"
